wwwwwwwwwwwwwwwwwwwww
wwwwwwwwwwwwwwwwwwwww
ww      r         www
ww                www
ww                www
ww                www
ww                www
ww              e www
ww       www   wwwwww
ww       www   wwwwww
ww       www   wwwwww
ww                www
ww                www
ww                www
ww                www
ww                www
ww     www        www
ww     www        www
ww     www        www
ww                www
ww                www
ww                www
ww                www
ww          www   www
ww          www   www
ww          www   www
ww                www
ww                www
ww                www
ww                www
ww    www         www
ww    www         www
ww    www         www
ww            wwwwwww
ww            wwwwwww
ww            wwwwwww
ww   www          www
ww   www          www
ww   www          www
ww        www     www
ww        www     www
ww        www     www
ww                www
ww                www
ww                www
ww                www
ww                www
wwwwwwwwwwwwww    www
wwwwwwwwwwwwww    www
wwwwwwwwwwwwww    www
ww                www
ww                www
ww               nwww
ww     wwwwwwwwwwwwww
ww     wwwwwwwwwwwwww
ww     wwwwwwwwwwwwww
ww                www
ww                www
ww                www
wwwwwwwwwwwww     www
wwwwwwwwwwwww     www
wwwwwwwwwwwww     www
ww                www
ww                www
ww   s            www
wwwwwwwwwwwwwwwwwwwww
wwwwwwwwwwwwwwwwwwwww
wwwwwwwwwwwwwwwwwwwww
wwwwwwwwwwwwwwwwwwwww
wwwwwwwwwwwwwwwwwwwww
wwwwwwwwwwwwwwwwwwwww
