wwwwwwwwwwwwwwwwwwwww
wwwwwwwwwwwwwwwwwwwww
ww                 ww
ww        r        ww
ww                 ww
ww                 ww
ww              e  ww
ww       www   www ww
ww       www   www ww
ww       www       ww
ww                 ww
ww                 ww
ww                 ww
ww                 ww
ww                 ww
ww     www         ww
ww     www         ww
ww                 ww
ww                 ww
ww                 ww
ww                 ww
ww                 ww
ww                 ww
ww          www    ww
ww          www    ww
ww                 ww
ww                 ww
ww                 ww
ww                 ww
ww    www          ww
ww    www          ww
ww                 ww
ww            www  ww
ww            www  ww
ww                 ww
ww   www           ww
ww   www           ww
ww                 ww
ww        www      ww
ww        www      ww
ww                 ww
ww                 ww
ww                 ww
ww                 ww
wwwwwwwwwwwwwwww   ww
wwwwwwwwwwwwwwww   ww
wwwwwwwwwwwwwwww   ww
ww                 ww
ww                 ww
ww                 ww
ww   wwwwwwwwwwwwwwww
ww   wwwwwwwwwwwwwwww
ww   wwwwwwwwwwwwwwww
ww                 ww
ww                 ww
ww                 ww
wwwwwwwwwwwwwwww   ww
wwwwwwwwwwwwwwww   ww
wwwwwwwwwwwwwwww   ww
ww                 ww
ww                 ww
ww        s        ww
wwwwwwwwwwwwwwwwwwwww
wwwwwwwwwwwwwwwwwwwww
ww                 ww
ww                 ww
ww                 ww
ww                 ww
ww                 ww
ww                 ww
ww                 ww
ww                 ww
ww                 ww
ww                 ww
