wwwwwwwwwwwwwwwwwwwww
wwwwwwwwwwwwwwwwwwwww
ww      r          ww
ww              e  ww
ww                 ww
ww                 ww
ww                 ww
ww              e  ww
ww       www   www ww
ww       www   www ww
ww       www       ww
ww                 ww
ww                 ww
ww                 ww
ww      n          ww
ww                 ww
ww     www         ww
ww     www         ww
ww                 ww
ww                 ww
ww                 ww
ww                 ww
ww           n     ww
ww                 ww
ww          www    ww
ww          www    ww
ww                 ww
ww                 ww
ww     n           ww
ww                 ww
ww    www          ww
ww    www      n   ww
ww                 ww
ww            www  ww
ww    n       www  ww
ww                 ww
ww   www           ww
ww   www   n       ww
ww                 ww
ww        www      ww
ww        www      ww
ww          n      ww
ww               s ww
ww  wwwwwwwwwwwwwwwww
ww  wwwwwwwwwwwwwwwww
ww                 ww
ww                 ww
wwwwwwwwwwwwwwww   ww
wwwwwwwwwwwwwwww   ww
wwwwwwwwwwwwwwww   ww
ww                 ww
ww                 ww
ww                 ww
ww   wwwwwwwwwwwwwwww
ww   wwwwwwwwwwwwwwww
ww   wwwwwwwwwwwwwwww
ww                 ww
ww                 ww
ww                 ww
wwwwwwwwwwwwwwww   ww
wwwwwwwwwwwwwwww   ww
wwwwwwwwwwwwwwww   ww
ww                 ww
ww                 ww
ww        s        ww
wwwwwwwwwwwwwwwwwwwww
wwwwwwwwwwwwwwwwwwwww
ww                 ww
ww                 ww
ww                 ww
ww                 ww
ww                 ww
ww                 ww
ww                 ww
ww                 ww
ww                 ww
ww                 ww
