wwwwwwwwwwwwwwwwwwwww
wwwwwwwwwwwwwwwwwwwww
ww        s        ww
ww                 ww
ww                 ww
ww                 ww
ww                 ww
ww    wwwwwwwww    ww
ww    wwwwwwwww    ww
ww    wwwwwwwww    ww
ww                 ww
ww           ww    ww
ww    ww     ww    ww
wwwwwwwwwwwwwwwwwwwww
wwwwwwwwwwwwwwwwwwwww
