wwwwwwwwwwwwwwwwwwwww
wwwwwwwwwwwwwwwwwwwww
ww      r         www
ww                www
ww                www
ww                www
ww                www
ww              e www
ww       www   wwwwww
ww       www   wwwwww
ww       www      www
ww                www
ww                www
ww                www
ww      n         www
ww                www
ww     www        www
ww     www        www
ww                www
ww                www
ww                www
ww                www
ww           n    www
ww                www
ww          www   www
ww          www   www
ww                www
ww                www
ww     n          www
ww                www
ww    www         www
ww    www      n  www
ww                www
ww            www www
ww    n       www www
ww                www
ww   www          www
ww   www   n      www
ww                www
ww        www     www
ww        www     www
ww                www
ww                www
ww                www
ww                www
ww                www
ww                www
wwwwwwwwwwwwww    www
wwwwwwwwwwwwww    www
wwwwwwwwwwwwww    www
ww                www
ww                www
ww            s  nwww
ww     wwwwwwwwwwwwww
ww     wwwwwwwwwwwwww
ww     wwwwwwwwwwwwww
ww                www
ww                www
ww                www
wwwwwwwwwwwww     www
wwwwwwwwwwwww     www
wwwwwwwwwwwww     www
ww                www
ww             n  www
ww                www
wwwwwwwwwwwwwwwwwwwww
wwwwwwwwwwwwwwwwwwwww
wwwwwwwwwwwwwwwwwwwww
wwwwwwwwwwwwwwwwwwwww
wwwwwwwwwwwwwwwwwwwww
wwwwwwwwwwwwwwwwwwwww
