wwwwwwwwwwwwwwwwwwwww
wwwwwwwwwwwwwwwwwwwww
ww                 ww
ww        r        ww
ww                 ww
ww                 ww
ww                 ww
ww    wwwwwwwww    ww
ww    wwwwwwwww    ww
ww    wwwwwwwww    ww
ww                 ww
ww                 ww
ww   wwwwwwwwwww   ww
ww                 ww
ww                 ww
ww                 ww
ww                 ww
ww          www    ww
ww                 ww
ww                 ww
ww                 ww
ww                 ww
ww                 ww
ww    www          ww
ww                 ww
ww       wwww      ww
ww       wwww      ww
ww                 ww
ww                 ww
ww                 ww
ww                 ww
ww                 ww
ww    s            ww
ww           ww    ww
ww    ww     ww    ww
wwwwwwwwwwwwwwwwwwwww
wwwwwwwwwwwwwwwwwwwww
